{
    "walls": [
        [1,1,1,1,1,1,1,1,1,1,1,1,1,1,1,1,1,1,1,1],
        [1,1,1,1,1,1,1,1,1,1,1,1,1,1,1,1,1,1,1,1],
        [1,1,0,0,0,0,0,0,0,0,0,0,0,0,0,0,0,0,1,1],
        [1,1,0,0,0,0,0,0,0,0,0,0,0,0,0,0,0,0,1,1],
        [1,1,0,0,0,0,0,0,0,0,0,0,0,0,0,0,0,0,1,1],
        [1,1,0,0,0,0,0,0,0,0,0,0,0,0,0,0,0,0,1,1],
        [1,1,0,0,0,0,0,0,0,0,0,0,0,0,0,0,0,0,1,1],
        [1,1,0,0,0,0,0,0,0,0,0,0,0,0,0,0,0,0,1,1],
        [1,1,0,0,0,0,0,0,0,0,0,0,0,0,0,0,0,0,1,1],
        [1,1,0,0,0,0,0,0,0,0,0,0,0,0,0,0,0,0,1,1],
        [1,1,0,0,0,0,0,0,0,0,0,0,0,0,0,0,0,0,1,1],
        [1,1,0,0,0,0,0,0,0,0,0,0,0,0,0,0,0,0,1,1],
        [1,1,0,0,0,0,0,0,0,0,0,0,0,0,0,0,0,0,1,1],
        [1,1,0,0,0,0,0,0,0,0,0,0,0,0,0,0,0,0,1,1],
        [1,1,0,0,0,0,0,0,0,0,0,0,0,0,0,0,0,0,1,1],
        [1,1,0,0,0,0,0,0,0,0,0,0,0,0,0,0,0,0,1,1],
        [1,1,0,0,0,0,0,0,0,0,0,0,0,0,0,0,0,0,1,1],
        [1,1,0,0,0,0,0,0,0,0,0,0,0,0,0,0,0,0,1,1],
        [1,1,1,1,1,1,1,1,1,1,1,1,1,1,1,1,1,1,1,1],
        [1,1,1,1,1,1,1,1,1,1,1,1,1,1,1,1,1,1,1,1]
    ],
    "placeable": [
        [0,0,0,0,0,0,0,0,0,0,0,0,0,0,0,0,0,0,0,0],
        [0,0,0,0,0,0,0,0,0,0,0,0,0,0,0,0,0,0,0,0],
        [0,0,1,1,1,1,1,1,1,0,0,0,0,0,0,0,0,0,0,0],
        [0,0,1,1,1,1,1,1,1,1,0,0,0,0,0,0,0,0,0,0],
        [0,0,1,1,1,1,1,1,1,0,0,0,0,0,0,0,0,0,0,0],
        [0,0,1,1,1,1,1,1,1,0,0,0,0,0,0,0,0,0,0,0],
        [0,0,0,0,0,0,0,0,0,0,0,0,0,0,0,0,0,0,0,0],
        [0,0,0,0,0,0,0,0,0,0,0,0,0,0,0,0,0,0,0,0],
        [0,0,1,1,0,0,0,0,0,0,0,0,0,0,0,0,0,0,0,0],
        [0,0,1,1,0,0,0,0,0,0,0,0,0,0,0,0,0,0,0,0],
        [0,0,0,0,0,0,0,0,0,0,0,0,0,0,0,0,0,0,0,0],
        [0,0,0,0,0,0,0,0,0,0,0,0,0,0,0,0,0,0,0,0],
        [0,0,0,0,0,0,0,0,0,0,0,0,0,0,0,0,0,0,0,0],
        [0,0,0,0,0,0,0,0,0,0,0,0,0,0,0,0,0,0,0,0],
        [0,0,0,0,0,0,0,0,0,0,0,0,0,0,0,0,0,0,0,0],
        [0,0,0,0,0,0,0,0,0,0,0,0,0,0,0,1,1,1,0,0],
        [0,0,0,0,0,0,0,0,0,0,0,0,0,0,0,1,1,1,0,0],
        [0,0,0,0,0,0,0,0,0,0,0,0,0,0,0,1,1,1,0,0],
        [0,0,0,0,0,0,0,0,0,0,0,0,0,0,0,0,0,0,0,0],
        [0,0,0,0,0,0,0,0,0,0,0,0,0,0,0,0,0,0,0,0]
    ],
    "rules": "B3/S23",
    "destination": [
        [17,17]
    ],
    "MAX_PLACED": 1000,
    "GRID_SIZE": 20
}